NO ./img/red.xpm
SO ./img/yellow.xpm
WE ./img/pink.xpm
EA ./img/blue.xpm
F 220,100,0
C 225,30,0

11111111111111111111111111111111111111111111111111
10000000000000000000000000000000000000000000000001
100N0111111100011111111111111110000011111110000001
10000001111000000000000000000000000000000000000001
10000001111000000000000000000000000000000000000001
10000001111000111111111111111110000000111111000001
10000000000000000000110000000000000000111111000001
10000000000111111100110000001111110000111111000001
10000000000000000000110000000000000000111111000001
10001111111111110000110000000000000000000000000001
10000000000000000000110111111111000000111111110001
11111111111111111000110111111111000000111100000001
11111111111111111000110000000000000000000000000001
10000000000000000000110010000001111111111111111111
10000000000000111000110000000001111111110000000001
10000000000000010000110001100001111111110000001111
10000000000000000000110001100000000000000000001111
10000011110000000000110001100000000000000000000001
10000011110000000000110000000001111111111111000001
10000011110000100000110010000000000000000000000001
10000011110000100000000010000000010000000000000001
10000011110000100000000010000011110000000000000001
10001111110000100001111111111111111111111000000001
10000111110000100000000011111111110000000000000001
10000111110000000000000111111111111000000000000001
10000011110000011001000011111111110000100011111111
10011111110000000000000000000000000001100000000001
10000011110000001111111111111111111111111111100001
10000011110000000011110000110000010010100000000001
10001111110000000011110000000000000000100010000001
10010011110000000011110000111000000000111111000001
10010000000000110011110000111000000010110000001001
10010000000000110000000000111000000011000001111001
10000011110000110000000000111000000000000000010001
11111111111111111111111111111111111111111111111111
