NO ./img/red.xpm
SO ./img/yellow.xpm
WE ./img/pink.xpm
EA ./img/blue.xpm
F 220,100,0
C 225,30,0
  11111111111111
  11111111111111
1110000000000001
10N0000000000001
1000111001110001
1000100000010001
1000100000010001
1000100000010001
1000111001110001
1000000000000001
1000000000000001
1000111111110001
1000000000000001
1000111111110001
1000000000000001
1111111111111111