NO ./img/red.xpm
SO ./img/yellow.xpm
WE ./img/pink.xpm
EA ./img/blue.xpm
F 220,100,0
C 225,30,0

1111111111111111
1000000000000001
1000000000000001
1000000000000001
10000000000N0001
1000000000000001
1000000000000001
1000000000000001
1000000000000001
1000000000000001
1000000000000001
1000000000000001
1000000000000001
     0000